#   v   #
#       #
#       #
#      ##
#     ###
#    ####
#   #####
#    ####
#     ###
#      ##
#       #
#       #
##      #
###     #
####    #
#####   #
####    #
###     #
##      #
#       #
##     ##
###   ###
#### ####
##### ###
###### ##
####### #
###### ##
##### ###
#### ####
### #####
## ######
## ######
# #######
#       #
#       #
#       #
#       #
###### ##
###### ##
###### ##
#####  ##
####   ##
###  # ##
##  ## ##
###### ##
###### ##
###### ##
#####  ##
####   ##
###  # ##
##  ## ##
#  ######
# #######
# #######
# #######
# #######
#-------#